{


  "volcano": [

    { "MAPA_ARCADE": "01",
      "blockers": 90,
      "grid": [
        [3,0,0,0,1,0,0,0,0,0,1,0,0,0,3],
        [0,1,0,1,1,0,1,0,1,0,1,1,0,1,0],
        [0,0,0,0,0,0,0,0,0,0,0,0,0,0,0],
        [0,1,7,1,1,0,1,1,1,0,1,1,7,1,0],
        [0,7,4,7,0,0,0,0,0,0,0,7,4,7,0],
        [0,1,7,1,1,0,2,2,2,0,1,1,7,1,0],
        [1,0,0,0,0,0,2,2,2,0,0,0,0,0,1],
        [0,1,7,1,1,0,2,2,2,0,1,1,7,1,0],
        [0,7,4,7,0,0,0,0,0,0,0,7,4,7,0],
        [0,1,7,1,1,0,1,1,1,0,1,1,7,1,0],
        [0,0,0,0,0,0,0,0,0,0,0,0,0,0,0],
        [0,1,0,1,1,0,1,0,1,0,1,1,0,1,0],
        [3,0,0,0,1,0,0,0,0,0,1,0,0,0,3]
      ]
    },
    { "MAPA_ARCADE": "02",
      "blockers": 90,
      "grid": [
        [3,0,0,0,1,0,0,0,0,0,1,0,0,0,3],
        [0,1,0,1,1,0,1,7,1,0,1,1,0,1,0],
        [0,0,0,0,1,0,7,4,7,0,1,0,0,0,0],
        [1,1,1,0,0,0,1,7,1,0,0,0,1,1,1],
        [0,0,0,0,1,0,0,0,0,0,1,0,0,0,0],
        [0,1,7,1,1,0,2,2,2,0,1,1,7,1,0],
        [0,7,4,7,0,0,2,2,2,0,0,7,4,7,0],
        [0,1,7,1,1,0,2,2,2,0,1,1,7,1,0],
        [0,0,0,0,1,0,0,0,0,0,1,0,0,0,0],
        [1,1,1,0,0,0,1,7,1,0,0,0,1,1,1],
        [0,0,0,0,1,0,7,4,7,0,1,0,0,0,0],
        [0,1,0,1,1,0,1,7,1,0,1,1,0,1,0],
        [3,0,0,0,1,0,0,0,0,0,1,0,0,0,3]
      ]
    },
	{ "MAPA_ARCADE": "03",
      "blockers": 90,
      "grid": [
        [3,0,0,0,0,1,0,1,0,1,0,0,0,0,3],
        [0,1,1,0,1,1,0,0,0,1,1,0,1,1,0],
        [0,0,1,7,1,0,0,1,0,0,1,7,1,0,0],
        [1,0,7,4,7,0,1,0,1,0,7,4,7,0,1],
        [0,0,1,7,1,0,0,0,0,0,1,7,1,0,0],
        [0,1,0,0,0,0,2,2,2,0,0,0,0,1,0],
        [0,0,0,1,0,1,2,2,2,1,0,1,0,0,0],
        [0,1,0,0,0,0,2,2,2,0,0,0,0,1,0],
        [0,0,1,7,1,0,0,0,0,0,1,7,1,0,0],
        [1,0,7,4,7,0,1,0,1,0,7,4,7,0,1],
        [0,0,1,7,1,0,0,1,0,0,1,7,1,0,0],
        [0,1,1,0,1,1,0,0,0,1,1,0,1,1,0],
        [3,0,0,0,0,1,0,1,0,1,0,0,0,0,3]
      ]
    }
  ],

  "basketball_court": [

    { "MAPA_ARCADE": "01",
      "blockers": 90,
      "grid": [
        [3,0,0,1,0,1,1,0,1,1,0,1,0,0,3],
        [0,1,0,0,0,0,0,0,0,0,0,0,0,1,0],
        [0,0,1,7,1,0,1,1,1,0,1,7,1,0,0],
        [1,0,1,7,1,0,1,1,1,0,1,7,1,0,1],
        [0,0,7,7,7,0,7,7,7,0,7,7,7,0,0],
        [1,0,1,4,1,7,2,2,2,7,1,4,1,0,1],
        [1,0,1,1,1,7,2,2,2,7,1,1,1,0,1],
        [1,0,1,4,1,7,2,2,2,7,1,4,1,0,1],
        [0,0,7,7,7,0,7,7,7,0,7,7,7,0,0],
        [1,0,1,7,1,0,1,1,1,0,1,7,1,0,1],
        [0,0,1,7,1,0,1,1,1,0,1,7,1,0,0],
        [0,1,0,0,0,0,0,0,0,0,0,0,0,1,0],
        [3,0,0,1,0,1,1,0,1,1,0,1,0,0,3]
      ]
    },
    { "MAPA_ARCADE": "02",
      "blockers": 90,
      "grid": [
        [3,0,0,0,0,1,1,1,1,1,0,0,0,0,3],
        [0,1,1,0,1,0,0,4,0,0,1,0,1,1,0],
        [0,1,1,0,0,7,1,7,1,7,0,0,1,1,0],
        [0,0,0,0,1,1,0,7,0,1,1,0,0,0,0],
        [1,0,1,0,0,0,7,7,7,0,0,0,1,0,1],
        [1,0,1,0,1,7,2,2,2,7,1,0,1,0,1],
        [1,0,4,7,7,7,2,2,2,7,7,7,4,0,1],
        [1,0,1,0,1,7,2,2,2,7,1,0,1,0,1],
        [1,0,1,0,0,0,7,7,7,0,0,0,1,0,1],
        [0,0,0,0,1,1,0,7,0,1,1,0,0,0,0],
        [0,1,1,0,7,0,1,7,1,7,0,0,1,1,0],
        [0,1,1,0,1,0,0,4,0,0,1,0,1,1,0],
        [3,0,0,0,0,1,1,1,1,1,0,0,0,0,3]
      ]
    },
	{ "MAPA_ARCADE": "03",
      "blockers": 90,
      "grid": [
        [3,0,0,0,4,7,7,7,0,0,1,0,0,0,3],
        [0,1,1,0,1,1,7,1,0,1,1,0,1,1,0],
        [0,0,1,0,1,0,0,0,0,0,1,0,1,0,0],
        [1,0,0,0,0,0,1,1,1,0,0,0,0,0,0],
        [0,0,1,0,1,0,7,7,7,0,1,0,1,0,4],
        [7,1,1,0,1,7,2,2,2,7,1,0,1,1,7],
        [7,7,0,0,0,7,2,2,2,7,0,0,0,7,7],
        [7,1,1,0,1,7,2,2,2,7,1,0,1,1,7],
        [4,0,1,0,1,0,7,7,7,0,1,0,1,0,0],
        [0,0,0,0,0,0,1,1,1,0,0,0,0,0,1],
        [0,0,1,0,1,0,0,0,0,0,1,0,1,0,0],
        [0,1,1,0,1,1,0,1,7,1,1,0,1,1,0],
        [3,0,0,0,1,0,0,7,7,7,4,0,0,0,3]
      ]
    }
  ]  

}